1 1 1 1 1 1 1 1 1 1 1 0 0 0 1 1 1 1 1 1 1 1 1
1 1 1 1 1 0 0 0 0 0 0 0 1 6 1 1 1 1 1 1 1 1 1
1 0 0 0 0 0 1 1 1 1 1 1 1 0 0 0 0 1 1 1 1 1 1
1 0 1 1 1 1 1 5 0 0 0 1 1 0 1 1 0 1 1 1 1 1 1
1 0 1 0 0 1 1 1 1 1 0 0 0 0 1 1 0 0 0 0 0 0 0
1 0 1 1 0 1 1 1 0 1 1 1 1 1 1 1 1 1 0 1 1 1 0
1 0 0 0 0 1 1 1 0 0 0 0 0 0 1 1 1 1 0 0 0 1 0
1 1 1 1 0 0 1 1 0 1 0 1 1 1 1 1 1 1 1 1 0 1 0
0 0 0 1 1 0 1 1 0 1 0 1 1 1 1 1 0 1 1 1 0 1 0
0 1 0 0 0 2 0 0 0 1 0 0 6 0 0 0 0 1 1 1 6 1 0
0 1 1 1 0 1 1 1 1 1 1 0 1 1 0 1 1 1 1 1 0 1 0
8 1 1 1 6 0 1 0 0 0 0 0 1 1 0 0 0 0 0 1 0 0 0
1 1 1 1 1 0 0 0 1 0 1 1 1 1 0 1 1 1 0 1 0 1 1
0 0 1 1 1 1 1 1 1 1 1 0 0 0 0 0 0 1 1 1 0 1 1
1 0 0 0 0 0 0 0 0 0 0 0 1 1 1 1 0 0 0 0 0 1 1